[alias]
  a = add
  aa = add -A
  ah = add -h
  ap = add --patch
  aas = !"f() { git add -A; git status; }; f"
  b = branch
  ba = branch --all
  bd = branch --delete
  bD = branch -D
  bh = branch -h
  bl = branch --list
  bu = branch --set-upstream-to
  bv = branch --verbose
  bvv = branch -vv
  cl = clone
  clb = clone --bare
  clbr = clone --branch
  clh = clone -h
  clo = clone --origin
  cm = commit
  cma = commit --all
  cmh = commit -h
  cmm = commit --message
  cmam = commit --all --message
  cmsq = commit --no-edit --squash
  cmasq = commit --all --no-edit --squash
  ch = checkout
  chb = checkout -b
  chd = checkout dev
  chf = checkout --force
  chh = checkout -h
  chm = checkout master
  cho = checkout --orphan
  cht = checkout --track
  chps = !"f() { git checkout $1; git pull --rebase=true --autostash; }; f"
  co = config
  cog = config --global
  cogr = !"f() { git config --global --get-regexp $1 | sed 's|'$1'.||'; }; f"
  cogra = !"f() { git config --global --get-regexp alias | sed 's|alias.||'; }; f"
  cogg = config --global --get
  cogga = !"f() { git config --global --get alias.$1; }; f"
  coh = config -h
  cogl = config --global --list
  col = config --local
  colr = !"f() { git config --local --get-regexp $1 | sed 's|'$1'.||'; }; f"
  colra = !"f() { git config --local --get-regexp alias | sed 's|alias.||'; }; f"
  colg = config --local --get
  colga = !"f() { git config --local --get alias.$1; }; f"
  coll = config --local --list
  d = diff
  f = fetch
  fh = fetch -h
  fp = fetch --prune
  logn = log --oneline -n
  m = merge
  ma = merge --abort
  mh = merge -h
  mm = merge master
  mnf = merge --no-ff
  ps = push
  psa = push --all
  psd = push --delete
  psh = push -h
  psf = push --force
  psp = push --prune
  pst = push --tags
  psu = push --set-upstream
  pl = pull
  pla = pull --all
  plh = pull -h
  plp = pull --prune
  plr = pull --rebase=true
  pls = pull --rebase=true --autostash
  plt = pull --tags
  rb = rebase
  rba = rebase --abort
  rbc = rebase --continue
  rbh = rebase -h
  rbi = rebase --interactive
  rbsq = rebase --interactive --autosquash
  rbsqs = rebase --interactive --autosquash --autostash
  rma = remote add
  rmh = remote -h
  rmp = remote prune
  rmrn = remote rename
  rmrv = remote remove
  rmu = remote set-url
  rmua = remote set-url --add
  rmud = remote set-url --delete
  rmv = remote --verbose
  rs = reset
  rsh = reset --hard
  rsm = reset --mixed
  rss = reset --soft
  rv = revert
  s = status
  sa = stash apply
  sb = stash branch
  sc = stash clear
  sd = stash drop
  sp = stash pop
  sl = stash list
  ss = stash save
  sski = stash save --keep-index
  ssnki = stash save --no-keep-index
  ssu = stash save --include-untracked
  ta = tag --annotate
  tam = !"f() { git tag --annotate $1 --message \\"$2\\"; }; f"
  td = tag --delete
  th = tag -h
  tl = tag --list
